15 15
10
###############
#$           $#
#$           $#
#$           $#
#$           $#
#$           $#
#$           $#
#$     *     $#
#$           $#
#$           $#
#$           $#
###############
